30303030303030313030303030303030
30303030313131303131313030303030
30303030310000000000313030303030
303030303200aa00aa00323030303030
30303030320000000000323030303030
30303030313232303232313030303030
30303030313131303131313030303030
30303030303030313030303030303030

image image:tilesheet
plant @6,3 0xff 0
hero @8,2
waterpattern (u16:waterpattern)single
