00000000000000000000000000000000
00000000002000000000010100000000
00000000002020000001010101000000
00000000000000000001010101000000
00000000000000000000010100000000
00000001000001000000000000000000
00000000000000000000000000200000
00000000000000000000000000000000

image image:scratch
