00000000000000000000000000000000
00000000000000000000010100000000
00000000000000000001010101000000
00000000000000000001010101000000
00000000000000000000010100000000
00000001000001000000000000000000
00000000000000000000000000000000
00000000000000000000000000000000

image image:scratch
plant @7,6 0xff 0
plant @2,6 0xff 0
plant @11,5 0xff 0
plant @10,2 0xff 0
plant @6,7 0xff 0
plant @6,6 0xff 0
