31313131313200000000013231313131
31313131320000000100000132313131
31313131320000000000000132313131
31313132000000000001010101323131
31313132000000000101010101323131
31313131320001010101010132313131
31313131320001010001010132313131
31313131313200010101013231313131

image image:tilesheet
hero @8,3
waterpattern (u16:waterpattern)three
