000000000000000000a7a8a900000000
0030000000000000d7b801b8d9003200
000000aa00d7d90000c7b8c900000000
00300000aa0000d7d900da0000000000
003000ba000000000000000000000000
000000da00aa00300030003000300000
00300000ba0000003000300030000000
00000000da0000000000000000000000

image image:tilesheet
waterpattern (u16:waterpattern)three
hero @6,3
