00000000000000000001010100000000
00300000000000000101010101003200
00000001000101000001010100000000
00300000010000010100010000000000
00300001000000000000000000000000
00000001000100300030003000300000
00300000010000003000300030000000
00000000010000000000000000000000

image image:tilesheet
waterpattern (u16:waterpattern)three
hero @6,3
