31313131010000010000013131313131
31313100000101010101000031313131
31310000000001320100000000313131
31310000000101010101000000313131
31310000000001010100000000313131
31310000000101000101000000313131
31313100010100000001010031313131
31313131010100000001013131313131

image image:tilesheet
waterpattern (u16:waterpattern)three
hero @7,5
