00000000000000000000000000000000
00000000000000000000000000000000
00000000000000000101010000000000
00000000000000000101010000000000
00003200000030000101010000000000
00000000310000000000000000000000
00000000000000000000000000000000
00000000000000000000000000000000

image image:tilesheet
hero @2,2
