00003100310031000031003100310000
00000031003100000000310031000000
00003100310000d7d900003100310000
003100310000ba3030ba000031003100
000031003100da3030da003100310000
00310031000000d7d900000031003100
00003100310000000000003100310000
00000031003100000000310031000000

image image:tilesheet
waterpattern (u16:waterpattern)single
hero @7,6
