00000000000000000000000000000000
00000000000000000000000000000000
0000000000000000a7a8a90000000000
0000000000000000b701b90000000000
0000320000003000c7c8c90000000000
00000000310000000000000000000000
00000000000000000000000000000000
00000000000000000000000000000000

image image:tilesheet
hero @2,2
waterpattern (u16:waterpattern)three
