00000000000000000000000000000000
00000000000000000000000000000000
00000001000100000001000100000000
00320000010001310100010001003200
00000001000100010001000100000000
00000100010001000100010001000000
30300101000000000000000000000000
30303000000000000000000000000000

image image:tilesheet
waterpattern (u16:waterpattern)little_l
hero @8,4
