00000000000000000000000000000000
000000000000d7d8d8d9000000000000
0000300000ba00000000ba0000310000
0000000000ca00a7a900ca0000000000
0000000000ca00c7c900ca0000000000
0000310000da00000000da0000300000
000000000000d7d8d8d9000000000000
00000000000000000000000000000000

image image:tilesheet
waterpattern (u16:waterpattern)three
hero @4,3
