00000000000000000000000000000000
00000000000001010101000000000000
00003000000100000000010000310000
00000000000100010100010000000000
00000000000100010100010000000000
00003100000100000000010000300000
00000000000001010101000000000000
00000000000000000000000000000000

image image:tilesheet
waterpattern (u16:waterpattern)three
hero @4,3
