00000000000000000000000000000000
00003200000001010101000000320000
00000000010101010101010100000000
00000001010101000001010101000000
00000001010101000001010101000000
00000000010101010101010100000000
00310000000001010101000000003000
00000000000000000000000000000000

image image:tilesheet
waterpattern (u16:waterpattern)three
hero @7,3
