00000000000000000000000000000000
000032000000a7a8a8a9000000320000
00000000a7a8b8c8c8b8a8a900000000
000000a7b8b8b90000b701b8a9000000
000000c7b8b8b90000b701b8c9000000
00000000c7c8b8a8a8b8c8c900000000
003100000000c7c8c8c9000000003000
00000000000000000000000000000000

image image:tilesheet
waterpattern (u16:waterpattern)three
hero @7,3
