30303030303030303030303030303030
30000000000000000000000000000030
30000000aa00aa000000aa0000000030
3000320000aa00aa31aa00aa00320030
30000000aa00aa00aa00aa0000000030
300000ba00aa00aa00aa00aa00000030
300030c7d90000000000000000000030
30303030303030303030303030303030

image image:tilesheet
waterpattern (u16:waterpattern)little_l
hero @8,4
