00000000000000000000000000000000
00000000000000000000000000000000
000000aa00aa000000aa00aa00000000
00320000aa00aa31aa00aa00aa003200
000000aa00aa00aa00aa00aa00000000
0000ba00aa00aa00aa00aa00aa000000
3030c7d9000000000000000000000000
30303000000000000000000000000000

image image:tilesheet
waterpattern (u16:waterpattern)little_l
hero @8,4
