00ba00000000000000a7a8a900000000
00c7d900000000a7a8b801b8a9000030
0000a7a900a7a8b8b801b801b9000000
0000b7b8a8b8b8b8b801b801b8a93000
0000b7b8c8b8b8b8b801b801b8c90000
0000b7c900c7b801010101b8c9000000
00d7c9000000c7b8b8b8b8c900000000
00000000000000c7c8c8c90000000000

image image:tilesheet
waterpattern (u16:waterpattern)tee
hero @5,1
plant @11,2 0xff 0
