00010000000000000001010100000000
00010100000000010101010101000030
00000101000101010101010101000000
00000101010101010101010101013000
00000101010101010101010101010000
00000101000101010101010101000000
00010100000001010101010100000000
00000000000000010101010000000000

image image:tilesheet
waterpattern (u16:waterpattern)tee
hero @5,1
plant @11,2 0xff 0
