00000000000000000000000000000000
0000d7d900000000a7a8a90000000030
000000a7a900a7a8b8b8b8a900000000
000000b7b8a8b8b8b8b801b8a9003000
000000b7b8c8c8b8b8b801b8c9000000
000000b7c90000c7b801b8c900000000
0000d7c900000000c7c8c90000000000
00000000000000000000000000000000

image image:tilesheet
waterpattern (u16:waterpattern)tee
hero @5,1
plant @10,3 0xff 0
