31313100000001010000000000313131
31000001010100000001010101000031
31000000000100000001000001000031
31000001010101010001000001000031
31000000000100000001000001000031
31000000010101000001000001000031
31000001000100010001010101000031
31313100000100000001000001313131

image image:tilesheet
waterpattern (u16:waterpattern)three
hero @7,4
