313131000000d7d90000000000313131
310000d7d8a9000000a7d8d8a9000031
3100000000ca000000ca0000ca000031
310000d7d8b8d8d900ca0000ca000031
3100000000ca000000ca0000ca000031
31000000d7b8d90000ca0000ca000031
310000aa00ca00aa00b7d8d8b9000031
3131310000da000000da0000da313131

image image:tilesheet
waterpattern (u16:waterpattern)three
hero @7,4
