00003100310031000031003100310000
00000031003100000000310031000000
00003100310000010100003100310000
00310031000001303001000031003100
00003100310001303001003100310000
00310031000000010100000031003100
00003100310000000000003100310000
00000031003100000000310031000000

image image:tilesheet
waterpattern (u16:waterpattern)single
hero @7,6
